150300000
049072065
000800003
000000590
100000070
060200400
403680007
002004009
000700108
